10.ox
...o......
....o.o...
..o.oo..o.
oo........
o.........
..o..oo.oo
oo.ooo....
.....o..o.
..o..o.ooo
o..o......
